**********************************************************************
**********************************************************************
**********************************************************************
**********************************************************************
**********************************************************************
**********************************************************************
**********************************************************************
*******........................................................*******
*******........................................................*******
*******........................................................*******
*******.............................*..........................*******
*******.............................*..........................*******
*******.............................*..........................*******
*******.............................*..........................*******
*******........................................................*******
*******........................................................*******
*******........................................................*******
*******........................................................*******
*******........................................................*******
*******...............******************************...........*******
*******........................................................*******
*******........................................................*******
*******........................................................*******
*******........................................................*******
*******........................................................*******
*******........................................................*******
*******........................................................*******
*******........................................................*******
*******........................................................*******
*******........................................................*******
*******........................................................*******
**********************************************************************
**********************************************************************
**********************************************************************
**********************************************************************
**********************************************************************
**********************************************************************
**********************************************************************
